Year,Country of Origin (ISO),Country of Origin,Country of Resettlement (ISO),Country of Resettlement,Female 0-17,Female 18-59,Female 60+,Female (unknown age),Female Total,Male 0-17,Male 18-59,Male 60+,Male (unknown age),Male Total,Other/Unknown,Grand Total
2017,AFG,Afghanistan,AUS,Australia,193,203,11,0,407,173,238,8,0,419,0,826
2017,SYR,Syrian Arab Rep.,BEL,Belgium,294,315,15,0,624,417,308,8,0,733,0,1357
2017,SOM,Somalia,PRT,Portugal,0,1,0,0,1,0,0,0,0,0,0,1
2017,SYR,Syrian Arab Rep.,MLT,Malta,4,4,0,0,8,2,1,0,0,3,0,11
2017,ERI,Eritrea,SWE,Sweden,108,186,10,0,304,136,197,18,0,351,0,655
2017,SDN,Sudan,FIN,Finland,6,4,0,0,10,8,2,0,0,10,0,20
2017,All others,All others,ISL,Iceland,3,6,0,0,9,0,5,0,0,5,0,14
2017,BTN,Bhutan,USA,United States of America,32,5,1,0,38,42,54,4,0,100,0,138
2017,AFG,Afghanistan,CAN,Canada,7,19,1,0,27,18,11,1,0,30,0,57
2017,SYR,Syrian Arab Rep.,IRL,Ireland,81,64,1,0,146,88,68,1,0,157,0,303
2017,ERI,Eritrea,USA,United States of America,233,246,9,0,488,256,240,15,0,511,0,999
2017,SDN,Sudan,FRA,France,82,74,7,0,163,86,73,3,0,162,0,325
2017,All others,All others,NLD,Netherlands,11,14,0,0,25,16,16,0,0,32,0,57
2017,SOM,Somalia,NLD,Netherlands,3,2,0,0,5,2,0,0,0,2,0,7
2017,SYR,Syrian Arab Rep.,ISL,Iceland,4,4,0,0,8,8,5,0,0,13,0,21
2017,SOM,Somalia,DEU,Germany,1,3,0,0,4,0,4,0,0,4,0,8
2017,IRQ,Iraq,USA,United States of America,362,391,42,0,795,439,437,27,0,903,0,1698
2017,IRQ,Iraq,ISL,Iceland,13,7,1,0,21,7,7,1,0,15,0,36
2017,IRN,Iran (Islamic Rep. of),AUS,Australia,2,14,0,0,16,3,9,0,0,12,0,28
2017,SDN,Sudan,GBR,United Kingdom of Great Britain and Northern Ireland,118,118,0,0,236,143,80,1,0,224,0,460
2017,All others,All others,URY,Uruguay,2,6,0,0,8,3,4,1,0,8,0,16
2017,COD,Dem. Rep. of the Congo,CAN,Canada,28,38,4,0,70,36,20,2,0,58,0,128
2017,All others,All others,BEL,Belgium,5,3,0,0,8,3,1,0,0,4,0,12
2017,SOM,Somalia,NOR,Norway,2,2,0,0,4,4,1,0,0,5,0,9
2017,MMR,Myanmar,AUS,Australia,64,77,3,0,144,70,99,2,0,171,0,315
2017,IRQ,Iraq,NLD,Netherlands,1,1,0,0,2,1,6,0,0,7,0,9
2017,IRQ,Iraq,DEU,Germany,2,3,0,0,5,3,2,0,0,5,0,10
2017,IRN,Iran (Islamic Rep. of),CAN,Canada,12,26,0,0,38,7,18,1,0,26,0,64
2017,SYR,Syrian Arab Rep.,DEU,Germany,869,924,97,0,1890,902,761,99,0,1762,0,3652
2017,All others,All others,DEU,Germany,9,21,1,0,31,11,11,1,0,23,0,54
2017,SOM,Somalia,NZL,New Zealand,6,7,1,0,14,2,4,0,0,6,0,20
2017,IRQ,Iraq,NOR,Norway,0,3,0,0,3,2,3,0,0,5,0,8
2017,IRQ,Iraq,FIN,Finland,1,2,0,0,3,1,1,0,0,2,0,5
2017,IRN,Iran (Islamic Rep. of),FRA,France,0,0,0,0,0,0,1,0,0,1,0,1
2017,IRQ,Iraq,NZL,New Zealand,4,14,1,0,19,9,22,3,0,34,0,53
2017,IRN,Iran (Islamic Rep. of),FIN,Finland,0,1,0,0,1,0,0,0,0,0,0,1
2017,IRN,Iran (Islamic Rep. of),GBR,United Kingdom of Great Britain and Northern Ireland,5,12,0,0,17,13,10,0,0,23,0,40
2017,ERI,Eritrea,ITA,Italy,55,71,3,0,129,68,64,9,0,141,0,270
2017,All others,All others,GBR,United Kingdom of Great Britain and Northern Ireland,65,100,4,0,169,89,64,6,0,159,0,328
2017,SOM,Somalia,SWE,Sweden,90,100,4,0,194,92,79,4,0,175,0,369
2017,SDN,Sudan,PRT,Portugal,0,2,0,0,2,1,3,0,0,4,0,6
2017,MMR,Myanmar,JPN,Japan,7,11,0,0,18,11,10,0,0,21,0,39
2017,All others,All others,LTU,Lithuania,1,4,1,0,6,0,2,1,0,3,0,9
2017,COD,Dem. Rep. of the Congo,AUS,Australia,354,291,14,0,659,360,275,12,0,647,0,1306
2017,SOM,Somalia,USA,United States of America,326,286,9,0,621,325,262,15,0,602,14,1237
2017,ERI,Eritrea,FIN,Finland,2,1,0,0,3,0,1,0,0,1,0,4
2017,SDN,Sudan,CAN,Canada,54,50,5,0,109,68,67,1,0,136,0,245
2017,All others,All others,SWE,Sweden,157,158,8,0,323,153,131,10,0,294,0,617
2017,COD,Dem. Rep. of the Congo,NLD,Netherlands,51,46,2,0,99,47,35,1,0,83,0,182
2017,COD,Dem. Rep. of the Congo,BEL,Belgium,39,48,3,0,90,30,48,1,0,79,0,169
2017,All others,All others,AUT,Austria,0,1,0,0,1,0,0,0,0,0,0,1
2017,SYR,Syrian Arab Rep.,ARG,Argentina,13,30,0,0,43,29,32,1,0,62,0,105
2017,SYR,Syrian Arab Rep.,ITA,Italy,249,222,5,0,476,343,242,1,0,586,0,1062
2017,IRQ,Iraq,MCO,Monaco,3,7,1,0,11,9,7,3,0,19,0,30
2017,IRN,Iran (Islamic Rep. of),NZL,New Zealand,1,3,0,0,4,2,4,0,0,6,0,10
2017,ERI,Eritrea,FRA,France,4,16,0,0,20,7,6,2,0,15,0,35
2017,SDN,Sudan,CHE,Switzerland,2,4,0,0,6,3,0,0,0,3,0,9
2017,MMR,Myanmar,NZL,New Zealand,31,31,4,0,66,43,65,3,0,111,0,177
2017,SYR,Syrian Arab Rep.,CYP,Cyprus,1,2,0,0,3,1,1,1,0,3,0,6
2017,All others,All others,CHE,Switzerland,3,5,0,0,8,5,1,1,0,7,0,15
2017,SYR,Syrian Arab Rep.,AUS,Australia,20,21,1,0,42,19,20,0,0,39,0,81
2017,SYR,Syrian Arab Rep.,LTU,Lithuania,44,42,2,0,88,58,43,2,0,103,0,191
2017,ERI,Eritrea,GBR,United Kingdom of Great Britain and Northern Ireland,15,9,0,0,24,14,4,0,0,18,0,42
2017,ERI,Eritrea,CAN,Canada,129,143,7,0,279,124,115,11,0,250,0,529
2017,SDN,Sudan,NLD,Netherlands,1,2,0,0,3,4,0,0,0,4,0,7
2017,SDN,Sudan,DEU,Germany,36,29,0,0,65,33,27,0,0,60,0,125
2017,MMR,Myanmar,SWE,Sweden,1,1,0,0,2,2,1,0,0,3,0,5
2017,All others,All others,FIN,Finland,7,15,0,0,22,10,14,0,0,24,0,46
2017,SYR,Syrian Arab Rep.,AUT,Austria,63,63,1,0,127,67,57,2,0,126,0,253
2017,SDN,Sudan,NOR,Norway,6,4,0,0,10,6,3,0,0,9,0,19
2017,MMR,Myanmar,USA,United States of America,1042,1161,38,0,2241,1025,1367,28,0,2420,0,4661
2017,All others,All others,FRA,France,124,107,3,0,234,112,112,1,1,226,0,460
2017,COD,Dem. Rep. of the Congo,FRA,France,5,7,0,0,12,11,4,0,0,15,0,27
2017,AFG,Afghanistan,NLD,Netherlands,0,0,0,0,0,1,0,0,0,1,0,1
2017,SYR,Syrian Arab Rep.,SWE,Sweden,715,598,43,0,1356,895,597,27,0,1519,0,2875
2017,SYR,Syrian Arab Rep.,NLD,Netherlands,699,611,39,0,1349,780,672,34,0,1486,0,2835
2017,SOM,Somalia,CAN,Canada,88,95,4,0,187,99,68,2,0,169,0,356
2017,SYR,Syrian Arab Rep.,ESP,Spain,334,279,4,0,617,448,297,7,0,752,0,1369
2017,ERI,Eritrea,DEU,Germany,0,4,0,0,4,3,7,0,0,10,0,14
2017,COD,Dem. Rep. of the Congo,SWE,Sweden,255,232,13,0,500,221,164,3,0,388,0,888
2017,SDN,Sudan,AUS,Australia,5,5,0,0,10,10,23,0,0,33,0,43
2017,All others,All others,KOR,Rep. of Korea,0,0,0,0,0,0,24,0,0,24,0,24
2017,COD,Dem. Rep. of the Congo,GBR,United Kingdom of Great Britain and Northern Ireland,55,82,4,0,141,62,59,1,0,122,0,263
2017,SYR,Syrian Arab Rep.,CAN,Canada,383,234,9,0,626,424,267,10,0,701,0,1327
2017,SYR,Syrian Arab Rep.,USA,United States of America,1089,793,27,0,1909,1137,840,56,0,2033,0,3942
2017,SYR,Syrian Arab Rep.,NOR,Norway,816,573,22,0,1411,1015,567,9,0,1591,0,3002
2017,SYR,Syrian Arab Rep.,EST,Estonia,33,34,3,0,70,38,34,1,0,73,0,143
2017,IRQ,Iraq,CAN,Canada,80,104,16,0,200,91,99,11,0,201,0,401
2017,IRN,Iran (Islamic Rep. of),NLD,Netherlands,0,1,0,0,1,0,2,0,0,2,0,3
2017,SDN,Sudan,SWE,Sweden,43,41,3,0,87,40,49,1,0,90,0,177
2017,COD,Dem. Rep. of the Congo,USA,United States of America,2559,2243,185,0,4987,2493,2126,149,0,4768,4,9759
2017,SDN,Sudan,BEL,Belgium,1,0,0,0,1,0,0,0,0,0,0,1
2017,MMR,Myanmar,KOR,Rep. of Korea,9,8,0,0,17,17,8,0,0,25,0,42
2017,All others,All others,NZL,New Zealand,77,106,2,0,185,71,81,1,0,153,0,338
2017,SYR,Syrian Arab Rep.,CHE,Switzerland,339,273,11,0,623,396,281,7,0,684,0,1307
2017,All others,All others,AUS,Australia,134,167,6,0,307,108,154,2,0,264,0,571
2017,SYR,Syrian Arab Rep.,NZL,New Zealand,205,113,5,0,323,229,123,3,0,355,0,678
2017,IRQ,Iraq,LUX,Luxembourg,0,0,0,0,0,0,2,0,0,2,0,2
2017,IRQ,Iraq,CHE,Switzerland,0,1,0,0,1,0,0,0,0,0,0,1
2017,SDN,Sudan,USA,United States of America,220,177,4,0,401,265,217,4,0,486,0,887
2017,ERI,Eritrea,AUS,Australia,81,118,1,0,200,80,99,7,0,186,0,386
2017,COD,Dem. Rep. of the Congo,NOR,Norway,7,8,0,0,15,8,8,0,0,16,0,31
2017,SYR,Syrian Arab Rep.,CHL,Chile,20,22,0,0,42,29,24,0,0,53,0,95
2017,All others,All others,CAN,Canada,240,205,9,0,454,242,208,5,0,455,0,909
2017,SYR,Syrian Arab Rep.,PRT,Portugal,63,37,1,0,101,76,44,0,0,120,0,221
2017,SOM,Somalia,AUS,Australia,25,72,3,0,100,32,39,0,0,71,0,171
2017,COD,Dem. Rep. of the Congo,NZL,New Zealand,0,1,0,0,1,1,1,0,0,2,0,3
2017,COD,Dem. Rep. of the Congo,FIN,Finland,51,38,0,0,89,54,37,0,0,91,0,180
2017,All others,All others,EST,Estonia,2,2,0,0,4,1,1,0,0,2,0,6
2017,SYR,Syrian Arab Rep.,ROU,Romania,13,8,0,0,21,13,14,0,0,27,0,48
2017,SYR,Syrian Arab Rep.,LVA,Latvia,12,14,0,0,26,25,14,0,0,39,0,65
2017,IRQ,Iraq,FRA,France,4,6,1,0,11,5,9,0,0,14,0,25
2017,BTN,Bhutan,AUS,Australia,0,0,0,0,0,1,0,0,0,1,0,1
2017,SYR,Syrian Arab Rep.,SVN,Slovenia,19,13,1,0,33,20,13,1,0,34,0,67
2017,SOM,Somalia,GBR,United Kingdom of Great Britain and Northern Ireland,68,89,6,0,163,72,32,0,0,104,0,267
2017,SYR,Syrian Arab Rep.,HRV,Croatia,40,36,0,0,76,44,35,2,0,81,0,157
2017,IRQ,Iraq,GBR,United Kingdom of Great Britain and Northern Ireland,167,184,8,0,359,171,114,6,0,291,0,650
2017,IRQ,Iraq,AUS,Australia,3,14,1,0,18,18,10,1,0,29,0,47
2017,All others,All others,ITA,Italy,6,21,0,0,27,16,11,2,0,29,0,56
2017,AFG,Afghanistan,NOR,Norway,1,1,0,0,2,1,0,0,0,1,0,3
2017,IRQ,Iraq,SWE,Sweden,9,18,4,0,31,10,14,1,0,25,0,56
2017,IRQ,Iraq,IRL,Ireland,0,2,0,0,2,0,3,0,0,3,0,5
2017,IRN,Iran (Islamic Rep. of),LUX,Luxembourg,0,0,0,0,0,0,1,0,0,1,0,1
2017,ERI,Eritrea,NLD,Netherlands,1,1,0,0,2,0,0,0,0,0,0,2
2017,All others,All others,NOR,Norway,14,12,0,0,26,16,8,0,0,24,0,50
2017,AFG,Afghanistan,NZL,New Zealand,10,4,0,0,14,5,8,1,0,14,0,28
2017,AFG,Afghanistan,FIN,Finland,2,1,1,0,4,3,4,0,0,7,0,11
2017,SYR,Syrian Arab Rep.,FIN,Finland,161,139,1,0,301,203,156,4,0,363,0,664
2017,IRQ,Iraq,ITA,Italy,0,1,0,0,1,0,3,0,0,3,0,4
2017,IRN,Iran (Islamic Rep. of),NOR,Norway,0,1,0,0,1,0,0,0,0,0,0,1
2017,ERI,Eritrea,NOR,Norway,3,1,0,0,4,3,1,0,0,4,0,8
2017,MMR,Myanmar,NOR,Norway,1,1,0,0,2,2,1,0,0,3,0,5
2017,All others,All others,USA,United States of America,436,598,21,0,1055,447,476,16,0,939,0,1994
2017,AFG,Afghanistan,SWE,Sweden,56,126,7,0,189,94,23,2,0,119,0,308
2017,AFG,Afghanistan,FRA,France,0,1,0,0,1,1,0,0,0,1,0,2
2017,All others,All others,BRA,Brazil,0,0,0,0,0,0,2,0,0,2,0,2
2017,SOM,Somalia,FIN,Finland,7,4,0,0,11,1,2,0,0,3,0,14
2017,SYR,Syrian Arab Rep.,FRA,France,1033,898,37,0,1968,1259,948,32,0,2239,0,4207
2017,IRN,Iran (Islamic Rep. of),SWE,Sweden,1,1,0,0,2,0,3,0,0,3,0,5
2017,ERI,Eritrea,NZL,New Zealand,0,0,0,0,0,2,0,0,0,2,0,2
2017,AFG,Afghanistan,USA,United States of America,204,197,11,0,412,217,199,12,0,428,0,840
2017,AFG,Afghanistan,GBR,United Kingdom of Great Britain and Northern Ireland,28,28,0,0,56,25,15,0,0,40,0,96
2017,All others,All others,ESP,Spain,0,1,0,0,1,2,1,0,0,3,0,4
2017,SYR,Syrian Arab Rep.,LUX,Luxembourg,58,46,4,0,108,50,57,1,0,108,0,216
2017,SOM,Somalia,FRA,France,48,25,0,0,73,39,13,0,0,52,0,125
2017,SYR,Syrian Arab Rep.,GBR,United Kingdom of Great Britain and Northern Ireland,1585,1742,81,0,3408,1935,1638,91,0,3664,0,7072
2017,IRN,Iran (Islamic Rep. of),DEU,Germany,1,1,0,0,2,2,0,0,0,2,0,4
2017,IRN,Iran (Islamic Rep. of),USA,United States of America,51,184,13,0,248,72,293,14,0,379,0,627
2017,ERI,Eritrea,PRT,Portugal,0,0,0,0,0,0,1,0,0,1,0,1
2017,MMR,Myanmar,CAN,Canada,22,22,3,0,47,25,25,5,0,55,0,102
2018,IRQ,Iraq,NZL,New Zealand,2,3,0,0,5,0,4,0,0,4,0,9
2018,IRN,Iran (Islamic Rep. of),GBR,United Kingdom of Great Britain and Northern Ireland,4,7,0,0,11,6,7,0,0,13,0,24
2018,ERI,Eritrea,ITA,Italy,0,3,0,0,3,1,6,0,0,7,0,10
2018,All others,All others,ISL,Iceland,1,4,0,0,5,1,14,0,0,15,0,20
2018,SYR,Syrian Arab Rep.,BGR,Bulgaria,24,10,1,0,35,20,11,0,0,31,0,66
2018,SOM,Somalia,SWE,Sweden,40,54,2,0,96,43,40,1,0,84,4,184
2018,SDN,Sudan,PRT,Portugal,13,12,0,0,25,9,11,0,0,20,0,45
2018,MMR,Myanmar,JPN,Japan,9,8,1,0,18,8,11,0,0,19,0,37
2018,All others,All others,NOR,Norway,29,19,1,0,49,26,18,0,0,44,0,93
2018,COD,Dem. Rep. of the Congo,AUS,Australia,689,485,20,0,1194,709,458,16,0,1183,0,2377
2018,SOM,Somalia,USA,United States of America,71,53,1,0,125,80,36,1,0,117,0,242
2018,ERI,Eritrea,FIN,Finland,1,24,0,0,25,2,30,0,0,32,0,57
2018,SDN,Sudan,CAN,Canada,135,142,2,0,279,140,172,4,0,316,10,605
2018,All others,All others,URY,Uruguay,4,6,0,0,10,2,6,0,0,8,0,18
2018,COD,Dem. Rep. of the Congo,NLD,Netherlands,51,47,0,0,98,56,34,2,0,92,0,190
2018,SYR,Syrian Arab Rep.,ARG,Argentina,3,1,0,0,4,4,1,0,0,5,0,9
2018,SYR,Syrian Arab Rep.,ITA,Italy,130,101,0,0,231,144,108,1,0,253,0,484
2018,ERI,Eritrea,FRA,France,7,57,0,0,64,7,221,0,0,228,31,323
2018,SDN,Sudan,ISL,Iceland,0,1,0,0,1,0,1,0,0,1,0,2
2018,SDN,Sudan,CHE,Switzerland,0,1,0,0,1,3,1,0,0,4,0,5
2018,MMR,Myanmar,NZL,New Zealand,29,18,1,0,48,21,9,1,0,31,0,79
2018,All others,All others,BRA,Brazil,1,1,0,0,2,0,4,0,0,4,0,6
2018,SYR,Syrian Arab Rep.,AUS,Australia,15,10,1,0,26,21,11,1,0,33,0,59
2018,SYR,Syrian Arab Rep.,LTU,Lithuania,6,2,0,0,8,3,2,0,0,5,0,13
2018,ERI,Eritrea,GBR,United Kingdom of Great Britain and Northern Ireland,46,41,2,0,89,61,20,2,0,83,3,175
2018,ERI,Eritrea,CAN,Canada,27,58,3,0,88,24,107,3,0,134,27,249
2018,SDN,Sudan,NLD,Netherlands,31,27,1,0,59,31,28,0,0,59,0,118
2018,MMR,Myanmar,SWE,Sweden,2,0,0,0,2,0,0,0,0,0,0,2
2018,All others,All others,ESP,Spain,0,0,1,0,1,0,1,0,0,1,0,2
2018,IRQ,Iraq,FRA,France,2,7,0,0,9,2,6,0,0,8,0,17
2018,ERI,Eritrea,CHE,Switzerland,2,39,1,0,42,9,12,0,0,21,6,69
2018,SDN,Sudan,NOR,Norway,30,31,2,0,63,38,27,0,0,65,0,128
2018,MMR,Myanmar,USA,United States of America,543,449,11,0,1003,661,493,8,0,1162,0,2165
2018,All others,All others,GBR,United Kingdom of Great Britain and Northern Ireland,88,116,10,0,214,112,91,3,0,206,1,421
2018,COD,Dem. Rep. of the Congo,FRA,France,6,3,0,0,9,7,3,0,0,10,0,19
2018,AFG,Afghanistan,NLD,Netherlands,0,1,0,0,1,0,0,0,0,0,0,1
2018,SYR,Syrian Arab Rep.,SWE,Sweden,525,464,44,0,1033,638,456,24,0,1118,0,2151
2018,SYR,Syrian Arab Rep.,NLD,Netherlands,546,535,23,0,1104,675,572,32,0,1279,0,2383
2018,SOM,Somalia,CAN,Canada,563,506,17,0,1086,615,406,20,0,1041,3,2130
2018,SYR,Syrian Arab Rep.,ESP,Spain,289,233,7,0,529,346,244,6,0,596,0,1125
2018,IRQ,Iraq,PRT,Portugal,18,39,1,0,58,21,29,0,0,50,0,108
2018,ERI,Eritrea,MLT,Malta,0,4,0,0,4,1,0,0,0,1,0,5
2018,ERI,Eritrea,DEU,Germany,19,79,0,0,98,45,133,0,0,178,5,281
2018,COD,Dem. Rep. of the Congo,SWE,Sweden,126,124,3,0,253,112,88,5,0,205,0,458
2018,SDN,Sudan,AUS,Australia,4,2,0,0,6,0,1,0,0,1,0,7
2018,All others,All others,NLD,Netherlands,15,23,0,0,38,20,19,0,0,39,0,77
2018,COD,Dem. Rep. of the Congo,GBR,United Kingdom of Great Britain and Northern Ireland,37,47,4,0,88,34,40,1,0,75,0,163
2018,SYR,Syrian Arab Rep.,CAN,Canada,1545,1090,65,0,2700,1701,1075,32,0,2808,0,5508
2018,SYR,Syrian Arab Rep.,USA,United States of America,28,17,1,0,46,26,13,0,0,39,0,85
2018,SYR,Syrian Arab Rep.,NOR,Norway,303,273,7,0,583,391,230,8,0,629,0,1212
2018,SYR,Syrian Arab Rep.,EST,Estonia,22,17,1,0,40,30,18,0,0,48,0,88
2018,IRQ,Iraq,CAN,Canada,197,298,36,0,531,198,290,30,0,518,0,1049
2018,IRN,Iran (Islamic Rep. of),NLD,Netherlands,0,3,0,0,3,0,0,0,0,0,0,3
2018,SDN,Sudan,SWE,Sweden,59,62,1,0,122,69,61,2,0,132,0,254
2018,COD,Dem. Rep. of the Congo,USA,United States of America,4208,3499,226,0,7933,4256,3299,200,0,7755,0,15688
2018,MMR,Myanmar,KOR,Rep. of Korea,14,21,2,0,37,14,27,0,0,41,0,78
2018,All others,All others,SWE,Sweden,145,163,6,0,314,157,152,0,0,309,52,675
2018,SYR,Syrian Arab Rep.,CHE,Switzerland,268,222,7,0,497,336,213,6,0,555,0,1052
2018,SYR,Syrian Arab Rep.,NZL,New Zealand,71,45,2,0,118,70,50,2,0,122,0,240
2018,SDN,Sudan,USA,United States of America,160,95,1,0,256,172,78,5,0,255,0,511
2018,ERI,Eritrea,AUS,Australia,56,52,0,0,108,65,29,0,0,94,0,202
2018,All others,All others,BEL,Belgium,3,2,0,0,5,1,2,0,0,3,5,13
2018,COD,Dem. Rep. of the Congo,NOR,Norway,310,303,10,0,623,343,238,7,0,588,0,1211
2018,SYR,Syrian Arab Rep.,PRT,Portugal,47,61,6,0,114,85,64,3,0,152,0,266
2018,SOM,Somalia,AUS,Australia,1,2,0,0,3,7,4,0,0,11,0,14
2018,All others,All others,DEU,Germany,6,7,1,0,14,0,4,1,0,5,2,21
2018,COD,Dem. Rep. of the Congo,NZL,New Zealand,24,26,3,0,53,26,25,2,0,53,0,106
2018,COD,Dem. Rep. of the Congo,FIN,Finland,35,34,1,0,70,35,35,2,0,72,0,142
2018,SYR,Syrian Arab Rep.,LVA,Latvia,1,1,0,0,2,1,1,0,0,2,0,4
2018,IRN,Iran (Islamic Rep. of),USA,United States of America,17,51,1,0,69,19,84,1,0,104,0,173
2018,ERI,Eritrea,PRT,Portugal,3,3,0,0,6,5,0,0,0,5,0,11
2018,MMR,Myanmar,CAN,Canada,63,67,3,0,133,84,76,1,0,161,0,294
2018,All others,All others,FRA,France,154,152,7,0,313,158,137,7,0,302,118,733
2018,BTN,Bhutan,AUS,Australia,0,0,0,0,0,1,0,0,0,1,0,1
2018,SOM,Somalia,GBR,United Kingdom of Great Britain and Northern Ireland,68,89,1,0,158,87,47,2,0,136,1,295
2018,SYR,Syrian Arab Rep.,HRV,Croatia,85,73,1,0,159,87,83,1,0,171,0,330
2018,IRQ,Iraq,GBR,United Kingdom of Great Britain and Northern Ireland,121,150,12,0,283,153,116,11,0,280,0,563
2018,IRQ,Iraq,AUS,Australia,4,5,0,0,9,3,3,0,0,6,0,15
2018,IRN,Iran (Islamic Rep. of),ITA,Italy,0,3,0,0,3,0,0,0,0,0,0,3
2018,All others,All others,KOR,Rep. of Korea,0,0,0,0,0,0,12,0,0,12,0,12
2018,AFG,Afghanistan,NOR,Norway,0,1,0,0,1,0,2,0,0,2,0,3
2018,SOM,Somalia,CHE,Switzerland,0,7,0,0,7,0,1,0,0,1,2,10
2018,IRQ,Iraq,SWE,Sweden,14,23,5,0,42,17,14,1,0,32,0,74
2018,IRQ,Iraq,IRL,Ireland,0,1,0,0,1,2,2,0,0,4,0,5
2018,ERI,Eritrea,NLD,Netherlands,5,11,1,0,17,7,29,0,0,36,0,53
2018,All others,All others,PRT,Portugal,16,26,0,0,42,26,12,1,0,39,0,81
2018,AFG,Afghanistan,NZL,New Zealand,46,79,1,0,126,43,34,3,0,80,0,206
2018,AFG,Afghanistan,FIN,Finland,2,3,0,0,5,2,1,0,0,3,0,8
2018,SYR,Syrian Arab Rep.,FIN,Finland,176,132,3,0,311,162,151,4,0,317,0,628
2018,IRN,Iran (Islamic Rep. of),NOR,Norway,0,3,0,0,3,0,1,0,0,1,0,4
2018,ERI,Eritrea,NOR,Norway,10,21,0,0,31,9,13,0,0,22,0,53
2018,All others,All others,AUS,Australia,310,292,7,0,609,295,261,10,0,566,0,1175
2018,AFG,Afghanistan,SWE,Sweden,112,175,10,0,297,95,45,5,0,145,0,442
2018,AFG,Afghanistan,FRA,France,2,2,0,0,4,2,6,0,0,8,0,12
2018,SOM,Somalia,FIN,Finland,0,2,0,0,2,0,3,0,0,3,0,5
2018,SYR,Syrian Arab Rep.,FRA,France,753,610,29,0,1392,895,635,20,0,1550,1,2943
2018,IRN,Iran (Islamic Rep. of),SWE,Sweden,2,7,0,0,9,1,11,0,0,12,0,21
2018,ERI,Eritrea,NZL,New Zealand,31,48,1,0,80,28,66,0,0,94,0,174
2018,ERI,Eritrea,BEL,Belgium,2,13,0,0,15,4,14,0,0,18,1,34
2018,All others,All others,CHE,Switzerland,0,1,0,0,1,0,0,1,0,1,0,2
2018,AFG,Afghanistan,USA,United States of America,610,745,33,0,1388,673,655,32,0,1360,0,2748
2018,AFG,Afghanistan,GBR,United Kingdom of Great Britain and Northern Ireland,39,64,3,0,106,40,35,1,0,76,0,182
2018,SOM,Somalia,FRA,France,9,22,0,0,31,5,26,0,0,31,9,71
2018,SYR,Syrian Arab Rep.,GBR,United Kingdom of Great Britain and Northern Ireland,975,974,50,0,1999,1129,920,31,0,2080,0,4079
2018,All others,All others,FIN,Finland,2,3,1,0,6,1,11,0,0,12,0,18
2018,AFG,Afghanistan,AUS,Australia,12,24,1,0,37,16,13,2,0,31,0,68
2018,SYR,Syrian Arab Rep.,BEL,Belgium,247,247,13,0,507,296,273,10,0,579,0,1086
2018,SOM,Somalia,PRT,Portugal,2,1,0,0,3,2,0,0,0,2,0,5
2018,SOM,Somalia,BEL,Belgium,1,4,0,0,5,3,4,0,0,7,0,12
2018,ERI,Eritrea,SWE,Sweden,96,157,4,0,257,130,310,4,0,444,5,706
2018,SDN,Sudan,FIN,Finland,1,4,0,0,5,0,0,0,0,0,7,12
2018,All others,All others,ITA,Italy,2,6,0,0,8,2,4,0,0,6,0,14
2018,BTN,Bhutan,USA,United States of America,0,0,0,0,0,2,0,0,0,2,0,2
2018,AFG,Afghanistan,CAN,Canada,70,82,7,0,159,64,94,8,0,166,0,325
2018,SYR,Syrian Arab Rep.,IRL,Ireland,87,83,1,0,171,125,93,0,0,218,0,389
2018,IRQ,Iraq,BEL,Belgium,0,1,0,0,1,0,0,0,0,0,0,1
2018,ERI,Eritrea,USA,United States of America,459,411,11,0,881,573,418,14,0,1005,0,1886
2018,SDN,Sudan,FRA,France,204,187,10,0,401,210,174,11,0,395,11,807
2018,All others,All others,NZL,New Zealand,103,126,6,0,235,121,106,8,0,235,0,470
2018,COD,Dem. Rep. of the Congo,ISL,Iceland,0,1,0,0,1,0,2,0,0,2,0,3
2018,SOM,Somalia,NLD,Netherlands,5,11,2,0,18,3,7,0,0,10,0,28
2018,SYR,Syrian Arab Rep.,ISL,Iceland,9,13,0,0,22,27,12,0,0,39,0,61
2018,SOM,Somalia,DEU,Germany,3,17,0,0,20,11,14,0,0,25,2,47
2018,IRQ,Iraq,USA,United States of America,172,264,35,0,471,188,285,31,0,504,0,975
2018,IRN,Iran (Islamic Rep. of),AUS,Australia,2,3,0,0,5,0,4,0,0,4,0,9
2018,SDN,Sudan,GBR,United Kingdom of Great Britain and Northern Ireland,107,87,2,0,196,124,63,1,0,188,0,384
2018,All others,All others,USA,United States of America,1177,1068,43,0,2288,1216,995,21,0,2232,31,4551
2018,COD,Dem. Rep. of the Congo,CAN,Canada,393,321,23,0,737,396,299,18,0,713,0,1450
2018,SOM,Somalia,NOR,Norway,2,1,0,0,3,2,0,0,0,2,0,5
2018,MMR,Myanmar,AUS,Australia,61,75,5,0,141,74,78,2,0,154,0,295
2018,IRQ,Iraq,NLD,Netherlands,2,4,0,0,6,3,3,0,0,6,0,12
2018,IRN,Iran (Islamic Rep. of),CAN,Canada,26,98,3,0,127,26,95,5,0,126,0,253
2018,SDN,Sudan,ITA,Italy,8,3,0,0,11,7,11,0,0,18,0,29
2018,All others,All others,CAN,Canada,524,631,10,0,1165,511,602,22,0,1135,101,2401
2018,SYR,Syrian Arab Rep.,DEU,Germany,1013,890,66,0,1969,1096,810,53,0,1959,0,3928
2018,SOM,Somalia,NZL,New Zealand,6,4,1,0,11,3,4,0,0,7,0,18
2018,IRQ,Iraq,NOR,Norway,2,3,0,0,5,4,1,0,0,5,0,10
2018,IRN,Iran (Islamic Rep. of),FRA,France,0,0,0,0,0,0,1,0,0,1,0,1
2019,COD,Dem. Rep. of the Congo,FIN,Finland,42,25,3,0,70,44,31,1,0,76,0,146
2019,IRQ,Iraq,FRA,France,0,0,0,0,0,0,1,0,0,1,0,1
2019,ERI,Eritrea,CHE,Switzerland,3,3,0,0,6,18,2,0,0,20,0,26
2019,SDN,Sudan,NOR,Norway,46,61,1,0,108,62,31,0,0,93,0,201
2019,COD,Dem. Rep. of the Congo,NZL,New Zealand,36,48,3,0,87,36,41,3,0,80,0,167
2019,MMR,Myanmar,USA,United States of America,527,278,18,0,823,613,280,12,0,905,0,1728
2019,All others,All others,NLD,Netherlands,26,34,0,0,60,23,19,0,0,42,0,102
2019,COD,Dem. Rep. of the Congo,FRA,France,2,10,0,0,12,5,11,0,0,16,0,28
2019,AFG,Afghanistan,NLD,Netherlands,0,0,0,0,0,0,4,0,0,4,0,4
2019,SYR,Syrian Arab Rep.,SWE,Sweden,634,538,23,0,1195,702,549,29,0,1280,0,2475
2019,SYR,Syrian Arab Rep.,NLD,Netherlands,188,243,12,0,443,275,263,12,0,550,0,993
2019,SOM,Somalia,CAN,Canada,574,648,26,0,1248,577,473,26,0,1076,0,2324
2019,SYR,Syrian Arab Rep.,ESP,Spain,267,238,7,0,512,303,262,5,0,570,0,1082
2019,IRQ,Iraq,PRT,Portugal,55,73,8,0,136,63,64,2,0,129,0,265
2019,IRN,Iran (Islamic Rep. of),KOR,Rep. of Korea,1,4,0,0,5,0,2,0,0,2,0,7
2019,ERI,Eritrea,MLT,Malta,0,1,0,0,1,0,0,0,0,0,0,1
2019,ERI,Eritrea,DEU,Germany,13,16,0,0,29,14,40,1,0,55,0,84
2019,COD,Dem. Rep. of the Congo,SWE,Sweden,138,115,3,0,256,146,94,7,0,247,0,503
2019,SDN,Sudan,AUS,Australia,0,0,0,0,0,0,2,0,0,2,0,2
2019,All others,All others,SWE,Sweden,211,224,2,0,437,210,207,2,0,419,1,857
2019,COD,Dem. Rep. of the Congo,GBR,United Kingdom of Great Britain and Northern Ireland,3,3,0,0,6,5,7,0,0,12,0,18
2019,SYR,Syrian Arab Rep.,CAN,Canada,1658,1351,49,0,3058,2004,1401,53,0,3458,0,6516
2019,SYR,Syrian Arab Rep.,USA,United States of America,115,3,0,0,118,102,4,0,0,106,0,224
2019,SYR,Syrian Arab Rep.,NOR,Norway,403,345,12,0,760,522,339,6,0,867,0,1627
2019,SYR,Syrian Arab Rep.,EST,Estonia,1,2,0,0,3,0,2,0,0,2,0,5
2019,IRQ,Iraq,CAN,Canada,101,160,17,0,278,113,168,18,0,299,0,577
2019,IRN,Iran (Islamic Rep. of),NLD,Netherlands,0,2,0,0,2,0,0,0,0,0,0,2
2019,SDN,Sudan,SWE,Sweden,81,65,2,0,148,112,90,1,0,203,0,351
2019,COD,Dem. Rep. of the Congo,USA,United States of America,3360,2643,183,0,6186,3419,2604,138,0,6161,0,12347
2019,MMR,Myanmar,KOR,Rep. of Korea,12,24,0,0,36,14,9,1,0,24,0,60
2019,SYR,Syrian Arab Rep.,CHE,Switzerland,263,230,4,0,497,343,229,4,0,576,0,1073
2019,SYR,Syrian Arab Rep.,NZL,New Zealand,8,3,1,0,12,5,3,0,0,8,0,20
2019,SOM,Somalia,DNK,Denmark,4,4,0,0,8,0,2,0,0,2,0,10
2019,SDN,Sudan,USA,United States of America,23,7,0,0,30,32,5,0,0,37,0,67
2019,ERI,Eritrea,AUS,Australia,49,55,2,0,106,34,34,2,0,70,0,176
2019,All others,All others,CAN,Canada,489,571,21,0,1081,510,546,13,1,1070,0,2151
2019,COD,Dem. Rep. of the Congo,NOR,Norway,306,370,8,0,684,323,243,4,0,570,0,1254
2019,COD,Dem. Rep. of the Congo,DEU,Germany,40,29,1,0,70,41,22,0,0,63,0,133
2019,SYR,Syrian Arab Rep.,PRT,Portugal,115,115,3,0,233,162,140,4,0,306,0,539
2019,SDN,Sudan,DEU,Germany,118,115,1,0,234,128,90,3,0,221,0,455
2019,All others,All others,FRA,France,197,194,4,0,395,147,152,5,0,304,1,700
2019,IRN,Iran (Islamic Rep. of),USA,United States of America,3,4,0,0,7,3,4,0,0,7,0,14
2019,ERI,Eritrea,PRT,Portugal,0,1,0,0,1,1,0,0,0,1,0,2
2019,MMR,Myanmar,CAN,Canada,35,38,2,0,75,27,37,1,0,65,0,140
2019,All others,All others,LUX,Luxembourg,0,1,0,0,1,0,2,0,0,2,0,3
2019,BTN,Bhutan,AUS,Australia,0,0,0,0,0,1,1,0,0,2,0,2
2019,SOM,Somalia,GBR,United Kingdom of Great Britain and Northern Ireland,66,108,2,0,176,75,46,0,0,121,0,297
2019,SYR,Syrian Arab Rep.,HRV,Croatia,10,8,1,0,19,15,7,0,0,22,0,41
2019,IRQ,Iraq,GBR,United Kingdom of Great Britain and Northern Ireland,44,59,6,0,109,52,43,1,0,96,0,205
2019,IRQ,Iraq,AUS,Australia,225,413,53,0,691,226,387,47,0,660,0,1351
2019,IRN,Iran (Islamic Rep. of),JPN,Japan,0,2,0,0,2,0,0,0,0,0,0,2
2019,All others,All others,PRT,Portugal,5,15,0,0,20,11,4,0,0,15,0,35
2019,AFG,Afghanistan,NOR,Norway,0,0,0,0,0,0,1,0,0,1,0,1
2019,SOM,Somalia,MLT,Malta,0,1,0,0,1,0,0,0,0,0,0,1
2019,IRQ,Iraq,SWE,Sweden,3,5,0,0,8,2,5,1,0,8,0,16
2019,IRQ,Iraq,IRL,Ireland,2,5,1,0,8,4,4,1,0,9,0,17
2019,ERI,Eritrea,NLD,Netherlands,12,21,0,0,33,14,40,0,0,54,0,87
2019,AFG,Afghanistan,NZL,New Zealand,35,35,2,0,72,40,28,0,0,68,0,140
2019,AFG,Afghanistan,FIN,Finland,1,1,0,0,2,2,1,0,0,3,0,5
2019,SYR,Syrian Arab Rep.,FIN,Finland,137,131,9,0,277,145,135,6,0,286,0,563
2019,ERI,Eritrea,NOR,Norway,22,61,0,0,83,25,38,0,0,63,0,146
2019,All others,All others,BRA,Brazil,5,14,0,0,19,14,12,0,0,26,0,45
2019,AFG,Afghanistan,SWE,Sweden,24,47,3,0,74,22,10,2,0,34,0,108
2019,AFG,Afghanistan,FRA,France,0,2,0,0,2,1,6,0,0,7,0,9
2019,SOM,Somalia,FIN,Finland,3,25,0,0,28,3,15,0,0,18,0,46
2019,SYR,Syrian Arab Rep.,FRA,France,431,341,10,0,782,474,354,10,0,838,0,1620
2019,IRQ,Iraq,ESP,Spain,0,1,0,0,1,0,0,0,0,0,0,1
2019,IRN,Iran (Islamic Rep. of),SWE,Sweden,0,1,0,0,1,2,2,0,0,4,0,5
2019,ERI,Eritrea,NZL,New Zealand,30,21,0,0,51,25,14,0,0,39,0,90
2019,IRN,Iran (Islamic Rep. of),FIN,Finland,0,0,0,0,0,0,3,0,0,3,0,3
2019,All others,All others,FIN,Finland,6,6,0,0,12,5,13,1,0,19,0,31
2019,AFG,Afghanistan,USA,United States of America,1184,1275,51,0,2510,1333,998,41,0,2372,0,4882
2019,AFG,Afghanistan,GBR,United Kingdom of Great Britain and Northern Ireland,33,55,5,0,93,41,40,6,0,87,0,180
2019,SYR,Syrian Arab Rep.,ROU,Romania,50,45,5,0,100,57,38,3,0,98,0,198
2019,SOM,Somalia,FRA,France,14,33,0,0,47,19,18,0,0,37,0,84
2019,SYR,Syrian Arab Rep.,GBR,United Kingdom of Great Britain and Northern Ireland,441,588,34,0,1063,589,525,48,0,1162,0,2225
2019,SOM,Somalia,AUS,Australia,7,2,0,0,9,7,0,0,0,7,0,16
2019,IRN,Iran (Islamic Rep. of),FRA,France,0,2,0,0,2,0,2,0,0,2,0,4
2019,SDN,Sudan,ESP,Spain,1,5,1,0,7,3,3,0,0,6,0,13
2019,All others,All others,JPN,Japan,1,1,0,0,2,0,1,0,0,1,0,3
2019,AFG,Afghanistan,AUS,Australia,61,97,6,0,164,75,96,5,0,176,1,341
2019,SYR,Syrian Arab Rep.,BEL,Belgium,170,188,9,0,367,199,171,7,0,377,0,744
2019,SOM,Somalia,PRT,Portugal,0,1,0,0,1,1,2,0,0,3,0,4
2019,ERI,Eritrea,SWE,Sweden,36,67,1,0,104,146,187,0,0,333,0,437
2019,ERI,Eritrea,LUX,Luxembourg,2,4,0,0,6,2,13,0,0,15,0,21
2019,SDN,Sudan,NZL,New Zealand,5,4,0,0,9,10,5,0,0,15,0,24
2019,SDN,Sudan,FIN,Finland,3,7,0,0,10,1,13,0,0,14,0,24
2019,All others,All others,NZL,New Zealand,115,148,8,0,271,138,141,6,0,285,0,556
2019,BTN,Bhutan,USA,United States of America,2,0,0,0,2,3,0,0,0,3,0,5
2019,AFG,Afghanistan,CAN,Canada,45,65,3,0,113,44,39,5,0,88,0,201
2019,SOM,Somalia,LUX,Luxembourg,0,8,0,0,8,1,9,0,0,10,0,18
2019,SYR,Syrian Arab Rep.,IRL,Ireland,199,193,3,0,395,261,189,6,0,456,0,851
2019,ERI,Eritrea,USA,United States of America,342,339,9,0,690,432,287,6,0,725,0,1415
2019,ERI,Eritrea,ESP,Spain,1,5,0,0,6,2,6,0,0,8,0,14
2019,SDN,Sudan,FRA,France,172,157,8,0,337,177,160,5,0,342,0,679
2019,All others,All others,USA,United States of America,945,1008,33,0,1986,982,911,22,0,1915,0,3901
2019,SOM,Somalia,NLD,Netherlands,13,14,0,0,27,9,8,0,0,17,0,44
2019,SOM,Somalia,DEU,Germany,197,166,4,0,367,184,119,4,0,307,0,674
2019,IRQ,Iraq,USA,United States of America,24,3,0,0,27,39,4,0,0,43,0,70
2019,IRN,Iran (Islamic Rep. of),AUS,Australia,6,51,0,0,57,5,64,1,0,70,1,128
2019,SDN,Sudan,GBR,United Kingdom of Great Britain and Northern Ireland,55,42,1,0,98,67,26,0,0,93,0,191
2019,MMR,Myanmar,NOR,Norway,1,1,0,0,2,0,4,0,0,4,0,6
2019,All others,All others,AUS,Australia,396,458,22,0,876,435,437,14,2,888,1,1765
2019,COD,Dem. Rep. of the Congo,CAN,Canada,425,458,30,0,913,412,363,25,0,800,0,1713
2019,SOM,Somalia,NOR,Norway,7,5,0,0,12,6,4,0,0,10,1,23
2019,MMR,Myanmar,AUS,Australia,62,98,2,0,162,54,54,3,0,111,0,273
2019,IRQ,Iraq,NLD,Netherlands,0,1,0,0,1,1,5,0,0,6,0,7
2019,IRQ,Iraq,DNK,Denmark,0,0,0,0,0,0,1,0,0,1,0,1
2019,IRN,Iran (Islamic Rep. of),CAN,Canada,13,60,3,0,76,7,44,1,0,52,0,128
2019,SDN,Sudan,LUX,Luxembourg,0,0,0,0,0,0,8,0,0,8,0,8
2019,All others,All others,DNK,Denmark,0,1,0,0,1,0,0,0,0,0,0,1
2019,SYR,Syrian Arab Rep.,DEU,Germany,2030,1765,164,0,3959,2294,1604,104,0,4002,0,7961
2019,SOM,Somalia,NZL,New Zealand,13,17,0,0,30,9,1,0,0,10,0,40
2019,IRQ,Iraq,NOR,Norway,0,0,0,0,0,0,4,0,0,4,0,4
2019,IRN,Iran (Islamic Rep. of),ESP,Spain,0,17,1,0,18,1,64,0,0,65,0,83
2019,All others,All others,GBR,United Kingdom of Great Britain and Northern Ireland,63,85,4,0,152,67,79,2,0,148,0,300
2019,AFG,Afghanistan,KOR,Rep. of Korea,0,0,0,0,0,0,1,0,0,1,0,1
2019,SYR,Syrian Arab Rep.,MLT,Malta,7,4,0,0,11,3,3,0,0,6,0,17
2019,IRQ,Iraq,NZL,New Zealand,0,0,0,0,0,3,1,0,0,4,0,4
2019,IRN,Iran (Islamic Rep. of),GBR,United Kingdom of Great Britain and Northern Ireland,1,2,0,0,3,2,0,0,0,2,0,5
2019,ERI,Eritrea,ITA,Italy,1,1,0,0,2,0,1,0,0,1,0,3
2019,MMR,Myanmar,GBR,United Kingdom of Great Britain and Northern Ireland,2,1,0,0,3,1,3,0,0,4,0,7
2019,All others,All others,NOR,Norway,222,156,3,0,381,218,87,1,0,306,0,687
2019,SYR,Syrian Arab Rep.,BGR,Bulgaria,41,39,0,0,80,49,39,0,0,88,0,168
2019,SOM,Somalia,SWE,Sweden,192,167,7,0,366,186,98,2,0,286,0,652
2019,SDN,Sudan,PRT,Portugal,12,8,0,0,20,7,6,1,0,14,0,34
2019,MMR,Myanmar,JPN,Japan,7,16,0,0,23,6,6,0,0,12,0,35
2019,All others,All others,URY,Uruguay,3,7,0,0,10,3,7,0,0,10,0,20
2019,COD,Dem. Rep. of the Congo,AUS,Australia,722,580,32,6,1340,755,565,26,0,1346,0,2686
2019,SOM,Somalia,USA,United States of America,61,20,1,0,82,60,12,1,0,73,0,155
2019,ERI,Eritrea,FIN,Finland,1,15,0,0,16,2,58,0,0,60,1,77
2019,SDN,Sudan,CAN,Canada,116,130,2,0,248,134,183,7,0,324,0,572
2019,SYR,Syrian Arab Rep.,ARG,Argentina,2,0,0,0,2,3,0,0,0,3,0,5
2019,SYR,Syrian Arab Rep.,ITA,Italy,114,84,3,0,201,119,88,2,0,209,0,410
2019,IRQ,Iraq,DEU,Germany,11,24,4,0,39,21,21,3,0,45,0,84
2019,ERI,Eritrea,FRA,France,8,27,0,0,35,13,138,0,0,151,0,186
2019,SDN,Sudan,CHE,Switzerland,0,0,0,0,0,3,0,0,0,3,0,3
2019,MMR,Myanmar,NZL,New Zealand,33,24,0,0,57,28,19,1,0,48,0,105
2019,All others,All others,DEU,Germany,73,63,7,0,143,71,34,1,0,106,0,249
2019,SYR,Syrian Arab Rep.,AUS,Australia,80,63,4,0,147,93,60,3,0,156,0,303
2019,IRQ,Iraq,FIN,Finland,0,0,0,0,0,0,3,0,0,3,0,3
2019,ERI,Eritrea,GBR,United Kingdom of Great Britain and Northern Ireland,14,30,0,0,44,16,19,0,0,35,0,79
2019,ERI,Eritrea,CAN,Canada,45,91,2,0,138,50,113,2,0,165,0,303
2019,SDN,Sudan,NLD,Netherlands,56,53,1,0,110,47,36,1,0,84,0,194
2019,MMR,Myanmar,SWE,Sweden,1,1,0,0,2,1,1,0,0,2,0,4
2020,AFG,Afghanistan,USA,United States of America,4,4,0,0,8,11,1,0,0,12,0,20
2020,AFG,Afghanistan,ISL,Iceland,6,8,0,0,14,7,3,0,0,10,0,24
2020,SYR,Syrian Arab Rep.,ROU,Romania,12,7,0,0,19,18,9,0,0,27,0,46
2020,SOM,Somalia,FRA,France,2,4,0,0,6,3,5,0,0,8,0,14
2020,SYR,Syrian Arab Rep.,GBR,United Kingdom of Great Britain and Northern Ireland,126,193,10,0,329,185,177,11,0,373,0,702
2020,SOM,Somalia,AUS,Australia,8,1,0,0,9,10,1,0,0,11,0,20
2020,SYR,Syrian Arab Rep.,DEU,Germany,276,225,11,0,512,323,202,7,0,532,0,1044
2020,IRN,Iran (Islamic Rep. of),USA,United States of America,1,0,0,0,1,2,0,0,0,2,0,3
2020,MMR,Myanmar,CAN,Canada,11,25,1,0,37,20,28,0,0,48,0,85
2020,All others,All others,URY,Uruguay,0,0,0,0,0,0,0,0,0,0,0,0
2020,SOM,Somalia,GBR,United Kingdom of Great Britain and Northern Ireland,22,34,2,0,58,22,26,2,0,50,0,108
2020,IRQ,Iraq,GBR,United Kingdom of Great Britain and Northern Ireland,0,0,0,0,0,2,0,0,0,2,0,2
2020,IRQ,Iraq,AUS,Australia,58,101,12,0,171,74,95,6,0,175,0,346
2020,AFG,Afghanistan,NOR,Norway,1,1,0,0,2,2,0,0,0,2,0,4
2020,AFG,Afghanistan,CHE,Switzerland,14,10,1,0,25,10,5,1,0,16,0,41
2020,ERI,Eritrea,NLD,Netherlands,9,11,0,0,20,9,10,0,0,19,0,39
2020,All others,All others,BRA,Brazil,0,0,0,0,0,0,0,0,0,0,0,0
2020,AFG,Afghanistan,NZL,New Zealand,22,37,0,0,59,44,23,1,0,68,0,127
2020,AFG,Afghanistan,FIN,Finland,3,1,1,0,5,0,0,0,0,0,0,5
2020,SYR,Syrian Arab Rep.,FIN,Finland,79,77,1,0,157,105,84,1,0,190,0,347
2020,IRN,Iran (Islamic Rep. of),NZL,New Zealand,2,2,0,0,4,0,1,0,0,1,0,5
2020,ERI,Eritrea,NOR,Norway,18,24,0,0,42,18,23,0,0,41,0,83
2020,All others,All others,FIN,Finland,8,9,0,0,17,6,8,1,0,15,0,32
2020,AFG,Afghanistan,SWE,Sweden,3,1,0,0,4,0,0,0,0,0,0,4
2020,AFG,Afghanistan,FRA,France,1,1,0,0,2,2,2,0,0,4,0,6
2020,SOM,Somalia,FIN,Finland,6,5,0,0,11,6,5,0,0,11,0,22
2020,SYR,Syrian Arab Rep.,FRA,France,313,262,7,0,582,378,266,4,0,648,0,1230
2020,IRN,Iran (Islamic Rep. of),CHE,Switzerland,2,3,0,0,5,1,8,0,0,9,0,14
2020,IRN,Iran (Islamic Rep. of),SWE,Sweden,0,1,0,0,1,2,1,0,0,3,0,4
2020,ERI,Eritrea,NZL,New Zealand,3,1,0,0,4,2,2,0,0,4,0,8
2020,MMR,Myanmar,AUS,Australia,17,15,3,0,35,20,18,2,0,40,0,75
2020,All others,All others,NLD,Netherlands,4,4,0,0,8,7,0,0,0,7,0,15
2020,SDN,Sudan,ESP,Spain,1,0,0,0,1,0,0,0,0,0,0,1
2020,All others,All others,SWE,Sweden,32,25,0,0,57,31,19,0,0,50,0,107
2020,AFG,Afghanistan,AUS,Australia,70,115,6,0,191,88,93,7,0,188,0,379
2020,SYR,Syrian Arab Rep.,BEL,Belgium,0,0,0,0,0,1,0,0,0,1,0,1
2020,ERI,Eritrea,SWE,Sweden,48,81,0,0,129,89,76,1,0,166,0,295
2020,SDN,Sudan,FIN,Finland,0,0,0,0,0,1,1,0,0,2,0,2
2020,AFG,Afghanistan,CAN,Canada,23,37,0,0,60,26,27,2,0,55,0,115
2020,SYR,Syrian Arab Rep.,IRL,Ireland,57,48,0,0,105,59,41,0,0,100,0,205
2020,SOM,Somalia,CHE,Switzerland,0,1,0,0,1,0,2,0,0,2,0,3
2020,ERI,Eritrea,USA,United States of America,0,0,0,0,0,2,0,0,0,2,0,2
2020,SDN,Sudan,FRA,France,40,35,3,0,78,27,24,1,0,52,0,130
2020,All others,All others,AUS,Australia,169,260,12,0,441,180,216,4,0,400,0,841
2020,SOM,Somalia,NLD,Netherlands,19,15,0,0,34,20,7,1,0,28,0,62
2020,SOM,Somalia,DEU,Germany,13,22,1,0,36,6,20,0,0,26,0,62
2020,IRQ,Iraq,USA,United States of America,8,0,0,0,8,10,0,0,0,10,0,18
2020,IRQ,Iraq,CHE,Switzerland,7,13,2,0,22,11,13,2,0,26,0,48
2020,IRN,Iran (Islamic Rep. of),AUS,Australia,0,2,0,0,2,0,2,0,0,2,0,4
2020,SDN,Sudan,GBR,United Kingdom of Great Britain and Northern Ireland,2,1,0,0,3,4,1,0,0,5,0,8
2020,All others,All others,DEU,Germany,37,36,0,0,73,31,24,0,0,55,0,128
2020,COD,Dem. Rep. of the Congo,CAN,Canada,159,171,12,0,342,171,146,14,0,331,0,673
2020,SOM,Somalia,NOR,Norway,30,30,1,0,61,13,13,0,0,26,0,87
2020,IRQ,Iraq,NLD,Netherlands,0,1,0,0,1,0,0,0,0,0,0,1
2020,IRN,Iran (Islamic Rep. of),CAN,Canada,2,5,0,0,7,1,2,1,0,4,0,11
2020,All others,All others,ISL,Iceland,0,4,0,0,4,3,3,0,0,6,0,10
2020,SOM,Somalia,NZL,New Zealand,35,44,2,0,81,37,18,1,0,56,0,137
2020,ERI,Eritrea,GBR,United Kingdom of Great Britain and Northern Ireland,2,0,0,0,2,0,0,0,0,0,0,2
2020,ERI,Eritrea,CAN,Canada,34,73,1,0,108,52,97,2,0,151,0,259
2020,All others,All others,NZL,New Zealand,60,65,1,0,126,65,58,0,0,123,0,249
2020,IRQ,Iraq,NZL,New Zealand,6,6,0,0,12,7,9,0,0,16,0,28
2020,MMR,Myanmar,GBR,United Kingdom of Great Britain and Northern Ireland,0,0,0,0,0,0,4,0,0,4,0,4
2020,SOM,Somalia,SWE,Sweden,2,1,0,0,3,4,1,0,0,5,0,8
2020,COD,Dem. Rep. of the Congo,ISL,Iceland,0,1,0,0,1,1,1,0,0,2,0,3
2020,COD,Dem. Rep. of the Congo,AUS,Australia,178,129,9,0,316,157,43,2,0,202,0,518
2020,SOM,Somalia,USA,United States of America,27,4,0,0,31,17,1,1,0,19,0,50
2020,SYR,Syrian Arab Rep.,ISL,Iceland,12,11,0,0,23,12,11,0,0,23,0,46
2020,ERI,Eritrea,FIN,Finland,1,0,0,0,1,1,1,0,0,2,0,3
2020,SDN,Sudan,CAN,Canada,55,53,2,0,110,53,82,1,0,136,0,246
2020,All others,All others,CHE,Switzerland,7,7,0,0,14,3,6,0,0,9,0,23
2020,SYR,Syrian Arab Rep.,ARG,Argentina,0,0,0,0,0,1,0,0,0,1,0,1
2020,SYR,Syrian Arab Rep.,ITA,Italy,11,17,0,0,28,27,22,0,0,49,0,77
2020,ERI,Eritrea,FRA,France,2,5,0,0,7,0,19,0,0,19,0,26
2020,SDN,Sudan,CHE,Switzerland,16,21,0,0,37,20,25,0,0,45,0,82
2020,MMR,Myanmar,NZL,New Zealand,21,21,0,0,42,21,21,0,0,42,0,84
2020,All others,All others,GBR,United Kingdom of Great Britain and Northern Ireland,1,4,0,0,5,2,6,0,0,8,0,13
2020,SYR,Syrian Arab Rep.,AUS,Australia,144,107,8,0,259,171,98,2,0,271,0,530
2020,All others,All others,NOR,Norway,90,65,0,0,155,66,30,0,0,96,0,251
2020,COD,Dem. Rep. of the Congo,FIN,Finland,44,39,0,0,83,48,33,1,0,82,0,165
2020,SYR,Syrian Arab Rep.,DNK,Denmark,8,6,0,0,14,11,6,0,0,17,0,31
2020,ERI,Eritrea,CHE,Switzerland,2,6,0,0,8,6,2,0,0,8,0,16
2020,SDN,Sudan,NOR,Norway,23,15,0,0,38,15,20,0,0,35,0,73
2020,COD,Dem. Rep. of the Congo,NZL,New Zealand,0,1,0,0,1,0,0,0,0,0,0,1
2020,MMR,Myanmar,USA,United States of America,19,0,0,0,19,18,1,0,0,19,0,38
2020,All others,All others,USA,United States of America,61,82,3,0,146,65,65,5,0,135,0,281
2020,COD,Dem. Rep. of the Congo,FRA,France,11,9,0,0,20,16,5,0,0,21,0,41
2020,SYR,Syrian Arab Rep.,SWE,Sweden,233,229,18,0,480,273,227,9,0,509,0,989
2020,SYR,Syrian Arab Rep.,NLD,Netherlands,149,161,6,0,316,155,194,6,0,355,0,671
2020,SOM,Somalia,ISL,Iceland,2,1,1,0,4,4,0,0,0,4,0,8
2020,SOM,Somalia,CAN,Canada,44,123,2,0,169,52,64,3,0,119,0,288
2020,SYR,Syrian Arab Rep.,ESP,Spain,0,0,0,0,0,1,0,0,0,1,0,1
2020,ERI,Eritrea,DEU,Germany,6,8,0,0,14,5,24,0,0,29,0,43
2020,COD,Dem. Rep. of the Congo,SWE,Sweden,11,16,1,0,28,21,14,0,0,35,0,63
2020,SDN,Sudan,AUS,Australia,0,0,0,0,0,0,1,0,0,1,0,1
2020,SYR,Syrian Arab Rep.,CAN,Canada,235,216,5,0,456,285,231,7,0,523,0,979
2020,SYR,Syrian Arab Rep.,USA,United States of America,3,3,0,0,6,4,0,0,0,4,0,10
2020,SYR,Syrian Arab Rep.,NOR,Norway,134,107,1,0,242,165,94,1,0,260,0,502
2020,IRQ,Iraq,CAN,Canada,23,30,5,0,58,20,32,3,0,55,0,113
2020,SDN,Sudan,SWE,Sweden,20,27,1,0,48,26,25,0,0,51,0,99
2020,COD,Dem. Rep. of the Congo,USA,United States of America,81,5,0,0,86,86,6,0,0,92,0,178
2020,All others,All others,CAN,Canada,153,210,5,0,368,162,161,4,0,327,0,695
2020,COD,Dem. Rep. of the Congo,NLD,Netherlands,0,1,0,0,1,0,0,0,0,0,0,1
2020,SYR,Syrian Arab Rep.,CHE,Switzerland,51,61,1,0,113,90,63,0,0,153,0,266
2020,SYR,Syrian Arab Rep.,NZL,New Zealand,1,0,0,0,1,2,0,0,0,2,0,3
2020,SDN,Sudan,USA,United States of America,2,0,0,0,2,3,0,0,0,3,0,5
2020,ERI,Eritrea,AUS,Australia,27,46,0,0,73,31,33,5,0,69,0,142
2020,All others,All others,FRA,France,96,72,3,0,171,76,58,0,0,134,0,305
2020,COD,Dem. Rep. of the Congo,NOR,Norway,109,129,3,0,241,126,117,1,0,244,0,485
2020,COD,Dem. Rep. of the Congo,DEU,Germany,25,20,0,0,45,24,26,0,0,50,0,95
2020,SYR,Syrian Arab Rep.,PRT,Portugal,1,0,0,0,1,0,0,0,0,0,0,1
2020,SDN,Sudan,DEU,Germany,25,22,0,0,47,22,7,0,0,29,1,77
,,,,,,,,,,,,,,,,
"Some data presented may differ from statistics published previously due to retroactive changes or the inclusion of previously unavailable data. In addition, resettlement departure figures reported by UNHCR may not match resettlement statistics published by States as Government figures may include individuals who were resettled outside of UNHCR processes. More information about UNHCR's resettlement programe can be found at http://www.unhcr.org/resettlement.html.",,,,,,,,,,,,,,,,
